20-*+
--------*---*-------
------------------*-
---*----*---------*-
**------*--------**-
---*----------------
--------------------
--------------------
------------*-------
-------------*------
-------------*------
-*---*------------*-
-------------*----*-
---*--------------*-
--------------------
------------*--*----
----------------*---
-----------*----*-*-
*---*-------------*-
--*-----------------
--------------------
